EA ./assets/berserk.xpm
WE ./assets/berserk_name.xpm
NO ./assets/berserk.xpm
SO ./assets/berserk.xpm

F 60,43,41
C 100,0,0

11111111111111
1111111111111111111111111111
100000000000000N000000000001
1000010000000000000000000001
1000010000000000000000000001
1010000000000000000000000001
1011110000011011110001111111
1000010111000000010001000001
1010010001011111000001000001
1011110101000101000000000001
1000000100010001000001000001
1111111111111111111111111111
11
1
1
1
