SO ./testxpm/green.xpm
WE ./testxpm/west.xpm
NO ./testxpm/wall.xpm
EA ./testxpm/d1.xpm

F 120,100,40
C 125,30,41

11111111
10011001
10010001
11000001
100100N1
11111111
