SO ./testxpm/green.xpm
WE ./testxpm/west.xpm
NO ./testxpm/wall.xpm
EA ./testxpm/d1.xpm

F 120,100,40
C 125,30,41

111111111111
100000011001
100001100001
110000000001
100100N00001
100110011001
100110001001
100000000001
111111111111
