SO ./assets/art.xpm
WE ./assets/art.xpm
NO ./assets/art.xpm
EA ./assets/art.xpm

F 116,102,59
C 135,206,235

11
11111111111
10000000111
10000001
1N0000001
10000111011
100111
10000100001
11111111111
1
11
