SO ./assets/art.xpm
WE ./assets/art.xpm
NO ./assets/art.xpm
EA ./assets/IMG_ace.xpm

F 116,102,59
C 135,206,25

1111
111111111111
100000001110
1000000111111111111
10000011
100000111
110S101
11101111
   1 
