SO ./assets/art.xpm
WE ./assets/art.xpm
NO ./assets/art.xpm
EA ./assets/art.xpm

F 116,102,59
C 135,206,235


111111111111
1000000011101
1000000111111111111
1N0000011
10000111011
100111111111111111111111111111
10000100001
11111111111
100000001
11111111