SO ./assets/art.xpm
WE ./assets/art.xpm
NO ./assets/art.xpm
EA ./assets/art.xpm

F 116,102,59
C 135,206,235

11111111111
1N000000001
10000111011
10000000001
10000100001
11111111111
