SO ./assets/art.xpm
WE ./assets/art.xpm
NO ./assets/art.xpm
EA ./assets/IMG_ace.xpm

F 116,102,59
C 135,206   ,,    25

1111
111111111111
1000000011101
1000000111111111111
1N0000011
100001111
1100001
11111111111
