SO ./testxpm/wall2.xpm
WE ./testxpm/wall8.xpm
NO ./testxpm/wall9.xpm
EA ./testxpm/wall7.xpm

F 116,102,59
C 135,206,235

1111111111111111111
1000000110000000001
1000N00011000000001
1010000101100001101
1001000000000000001
1000000110000000001
1000000110000000001
1000000110000000001
1000000110000000001
1000000110000000001
1000000110000000001
1000000110000000001
1000000110000000001
1000000110000000001
1000000110000000001
1000000110000000001
1000000110000000001
1000000110000000001
1000000110000000001
1000000110000000001
1000000110000000001
1000000110000000001
1111111111111111111
