SO ./testxpm/wall2.xpm
WE ./testxpm/wall8.xpm
NO ./testxpm/wall9.xpm
EA ./testxpm/wall7.xpm

F 116,102,59
C 135,206,235

1111111111111111111
1001000011000000001
1010000101100001101
1010000101100001101
1000000110000000001
1000N00011000000001
1010000101100001101
1001000000000000001
1001100000001100001
1001100010011110001
1000000000010000011
1111111111111111111
