SO ./assets/rick_morty_theme.xpm
WE ./assets/rick_morty.xpm
EA ./assets/rick_morty2.xpm
NO ./assets/rick_morty3.xpm

C 88,120,0
F 42,8,10

1111111111111111111
1001000011000000001
1010000101100001101
1010000101100001101
1000000110000000001
100W00011000000001
1010000101100001101
1001000000000000001
1001100000001100001
1001100010011110001
1000000000000000001
111111110111111111
11111   1
